#########
 #   ####
 #      #
### **# #
#  #* *@#
#   * ###
#  ##  ##
##     ##
 #.$#  ##
 #  #####
 ########